8
5
--4-----
www---ww
ww--h-ww
cwh---mw
-----h-c